20 20
XXXXXXXXXXXXXXXXXXXX
XXXXXOOOOOOOOOOOOOOX
XXXXXOXXXXXXOXXXXXOF
XXXXXOXXXXXXOXXXXXXX
XXXXXOXXXXXXOXXXXXXX
XOOOOOXXXXXXOXXXXXXX
XXXXXOXXXXXXOXXXXXXX
XXXXXOXXXXXXOXXXXXXX
XXXXXOXXXXXXOXXXXXXX
XXXXXXXXXXXXOXXXXXXX
XXXXXXXXXXXXOXXXXXXX
XXXXXXXXXXXXSXXXXXXX
XXXXXXXXXXXXXXXXXXXX
XXXXXXXXXXXXXXXXXXXX
XXXXXXXXXXXXXXXXXXXX
XXXXXXXXXXXXXXXXXXXX
XXXXXXXXXXXXXXXXXXXX
XXXXXXXXXXXXXXXXXXXX
XXXXXXXXXXXXXXXXXXXX
XXXXXXXXXXXXXXXXXXXX
