6 8
XXXXXXFX
XOOOOOOX
XOXOOXOX
XOXXOXOX
XOOXSXOX
XXXXXXXX
