6 8
XXXXXXXX
XOOOOOOX
XOXOOXOX
XOXXOXOX
XOOXSXOX
XXFXXXXX
