6 8
XXXXXXXX
XOOOOOOX
XOXOOXOX
XXXXOXOX
XOOXSXOX
XXFXXXXX
